#################################################################
#S#           #   #   #         #           #             #     #
# ####### ### # # # # ### ##### ### ######### # ######### ##### #
#   #     # #   #   #     # #   #   #   #     #     #   #       #
### # ##### ############### # ### ### # # ######### # # ####### #
# # # #     #       #       # #       #     #     # # #     #   #
# # # ### ### ### ### # ##### ############### ### # # ##### # ###
#   #   #   # #   #   # #     #   #   #       #   # # #   #   # #
# ##### # # # # ### ### # ##### # # # # ####### ### # # # ##### #
#       # #   #       #         #   #   #           #   #      E#
#################################################################
