#########################
#S  #         #         #
### ##### # # ######### #
# #     # # # #     #   #
# ##### ### # # ### # # #
#     #     # # #   # # #
# # ######### # # ### ###
# #     #     # # #     #
# ##### # ##### # ### # #
#     # #   #   #   # # #
##### # ### # # ### ### #
# #   #   # # # # #     #
# # ### ### # # # ##### #
# #   #     # # #     # #
# ### ####### # # ### # #
#     #     # # #   # # #
# ####### # # # ### ### #
#   #     # # #   #     #
### ### ### # ### # #####
# # #   #   # # # #     #
# # # ### ### # # ##### #
# # # # #   #   #   # # #
# # # # ### ####### # # #
#     #             #  E#
#########################
