#########################
#S  #         #         #
### ##### # ### # ##### #
# #     # #     # # #   #
# ##### # ####### # # ###
# #     #       # # # # #
# # ######### ### # # # #
# # #   #   # #   # #   #
# # # # # # ### ### ### #
# # # #   #   #   # #   #
# # # ####### # # # # ###
#   # #     # # # #     #
# ### # ### # # # #######
#     # # # # # #       #
####### # # # ### ##### #
# #   #   # #   #     # #
# # # # ### ### ##### # #
#   # # #     # #     # #
# ### # # ### # ### ### #
# #   # #   # #   #   # #
# # ### ### ##### ##### #
# #   # # #     #   #   #
# ### # # ### ##### # # #
#   #       #         #E#
#########################
