#########################
#S  #             #     #
### ####### # ### ### # #
# #   #   # # #       # #
# ### # # # # ###########
#   #   # # #           #
# # ##### # ########### #
# # #     # #         # #
# # # ##### # ######### #
# #   #     #     #   # #
# ######### ##### # # # #
#         #       # #   #
######### ####### # #####
#       # #   #   #     #
# ### # # # # ##### ### #
# #   # # # #     #   # #
# # ##### # ##### # ### #
# #       #     # # #   #
# ############# # # # ###
#     #     #   # # #   #
##### # ### # ### # ### #
#   # # #   # # # #   # #
# ### # # ### # # ##### #
#       #     #        E#
#########################
