#########################
#S#   #           #     #
# # # # ######### # # # #
#   # # #     #   # # # #
##### # # ### # ##### # #
#   # # # # #         # #
# # # # # # ####### #####
# # # # #   # #   # #   #
# ### # ### # # # # # # #
#     #   #   # # # # # #
# ##### # ##### # ### # #
# #     #     # #   # # #
# ##### ##### # ### # # #
#     # #   #     #   # #
##### ### # ##### ##### #
# #   #   #   # #   #   #
# # ### ##### # ### # ###
#   #     #   #   # #   #
# ### ### ### ### # ### #
# #     #   #   #     # #
# ######### ### # ##### #
#           #   # #     #
############# ##### ### #
#                   #  E#
#########################
