#########################
#S#               #     #
# ####### ### ### # # # #
#       # #   # # # # # #
####### # # ### # ### # #
#     # # # #   # #   # #
# ### # ### # # # # ### #
#   # #   # # #     #   #
### # ### # # ######### #
#   #     # # #       # #
# ######### ### ##### ###
#   #       #   #   #   #
### # # ### # ### ##### #
#   # #   # #   # #     #
# ### ### ##### # # ### #
# #   # #         #   # #
# ### # ######### ### ###
#   #     #     #   #   #
### ####### ### ####### #
# #         #   #       #
# ########### ### ##### #
# #         #   #   #   #
# # ####### ### ### # ###
#         #         #  E#
#########################
