#########################
#S#         #           #
# # ##### ### ######### #
# #     #     #         #
# ##### ####### ####### #
#   #   #       #     # #
### # ### ########### # #
#   # #   #   #       # #
# ##### ### ### # ### # #
#     #   # #   #   # # #
##### ### # # ##### # # #
#     #   #   # #   # # #
# ##### ##### # # ### # #
#   #   #   #   # #   # #
### ### # # # ### # ### #
# #   # # # # #   #   # #
# ### # # # ### ####### #
#     #   #   #         #
# ########### # #########
# #     #   # # #       #
# # ### # # # # # ##### #
# #   #   #   # #   #   #
# ### ######### ##### # #
#     #               #E#
#########################
