#################################################################
#S    #   # #                 #           #     #   #   #       #
##### # # # # ########### ### # ######### ### # # # # # # # #####
# #   # # #     #         # #   #       #     # # # # #   #     #
# # ### # ####### ######### ####### ########### # # # ######### #
#   #   #         #     #   #     # #         # # # #         # #
# ##### ########### ##### # # # # # # # # ##### # ### ######### #
#   #   #           #     # # # #   # # # #     #     #       # #
### # ### ######### # ##### # # ##### # ### ########### ##### # #
#     #           #       #   #       #                 #      E#
#################################################################
