#########################
#S#       #   #     #   #
# ##### # # # # # # # # #
#       # # #   # # # # #
######### # ##### ### # #
#   #     #     #     # #
# # # ######### ####### #
# # # #       # #     # #
# # # # # ### # # ### # #
# # # # # #   # # #   # #
# ### # # # ### # # ### #
# #   # # # #   # #     #
# # ##### # # ### ##### #
# #     # # # #   #   # #
# ##### # # # # ### # # #
#     # # # # # #   # # #
# ### # # # ### # ### # #
# #   # # #     # #   # #
# ##### # ####### # ### #
#       # #   #   # #   #
# ####### # # # ### # ###
#     #   # #   # # #   #
##### ### # ##### # ### #
#         #       #    E#
#########################
