#################################################################
#S#     #       # #         #     #   #       #             #   #
# ### # # ##### # # # ##### ### # # # ##### # # ### ####### # ###
#   # # # #     # # # #   #   # #   # #     # #   # #     # #   #
### # # # # ##### # # # # ### # ##### # ##### ##### # ##### ### #
# #   #   # #       # # #     # #     # #   #     # # #   #   # #
# ######### ######### # ####### # ##### # ####### # # # # ### # #
#       #   #       # # #       # #     #       #   # # # #   # #
# ##### # ### ##### # # ### ##### # ##### # ######### # # # ### #
#     #       #       #     #       #     #             #      E#
#################################################################
