#########################
#S  #       #       #   #
### # # ### # # ##### # #
#   # # # # # #       # #
# ### # # # # ####### # #
# #   # # # # #     # # #
# # ### # # ### ### # # #
# # #   # #   # # # # # #
# ### ### ### # # # # # #
#     #     # # # # # # #
######### # # # # # ### #
#         # #   # # #   #
# ##### ######### # # # #
# #   #       #   #   # #
# ### ##### # # # ##### #
#     #     # # #     # #
####### ####### # ##### #
#   #   #       #       #
# # # ### ###############
# # # #   #             #
# # # # ##### ######### #
# #   #     # #       # #
# ######### # # ### ### #
#             #   #    E#
#########################
