#################################################################
#S      #                 #       #         #         #   #     #
####### ############### # ##### # ####### # # # ##### # # # # # #
#   # # #     #         #     # #         # # # #     # #   # # #
# # # # # ### # ############# # ########### ### # ##### ##### ###
# #   #   # #   # #     #   # #   #       #   # #   #       #   #
# ######### ##### # # ### # # ### # ######### # ### ##### ##### #
#     #       #     #     # # #   #         # #   #     # #     #
# ### # ### ### ########### # # ### ####### # ### ##### ### ### #
#   #     #               #     #         #       #         #  E#
#################################################################
