#################################################################
#S  #         # #     #     #     #           #                 #
### ##### # # # # ### # # # ### # # ######### ##### ########### #
# #     # # # #     #   # # #   # # # #   #   #   #       #   # #
# ##### ### # ######### # # # ### # # # # # ### # # ##### # ### #
#     #     # #       # # # # # #   # # # # #   # # #     #     #
# # ######### # ##### ### # # # ##### # # # # ### ### ##### #####
# #     #     #   # #   # # # #       # #   #   # #   #   #     #
# ##### # ####### # ### # # # # ####### ####### # # ### # ##### #
#     #           #       #   #                 #   #   #      E#
#################################################################
