#########################
#S    #                 #
##### # ############# # #
# #   #     #     #   # #
# # ####### # # ### ### #
# #   # #   # # #   # # #
# ### # # ### ### ### # #
#   # #     #   #   #   #
# # # ##### ### ### #####
# # # #   #   #   #     #
# ### # # ### ### ##### #
# #   # # # #     #     #
# # ### # # ##### # ### #
# # #   # #     # #   # #
# # # ### ##### # ### # #
#   # # # #   # # # # # #
# ### # # # # # # # # ###
# #   # #   # # #   #   #
# # ### ##### # # ##### #
# # #   #     #   #     #
# # # # # ######### ### #
#   # # # #         # # #
##### # # # ######### # #
#     #     #          E#
#########################
