#########################
#S#   #         # #     #
# # ### ### ### # # ### #
# #       #   #   # #   #
# ######### # ##### # # #
#         # # #     # # #
######### ### # ##### # #
#       #   # # #   # # #
# # # ##### # # # # # ###
# # # #     # #   # #   #
# # ### ##### ##### ### #
# # #   #   #     # #   #
# # # ### # # # ### # ###
# #   #   # # #     #   #
# ##### ### # ######### #
# #     # # # #       # #
# # ##### # ### ##### # #
# # #     #   #   # # # #
# # # # ##### ### # # # #
#   # #     #     # #   #
##### ##### ####### ### #
#   # # #         #     #
# ### # # ######### #####
#       #              E#
#########################
