#################################################################
#S  # #       #                     #   #                       #
### # # ##### # ########### ####### # # # ##################### #
# # # # #   #       #     #   #   # # #   #     #     #     #   #
# # # # # ##### ##### ### # # # # # # ##### ### # # ### # ### ###
#   #     #   # #     #   # #   # #   #   #   # # #     # #   # #
# ######### # ### ##### ##### ### ##### ##### # # ####### # ### #
# #     #   #     #   # #   #   #     #   #   # #   #   #   #   #
# # ### # ######### ### # # ######### # # # ### ### # # ####### #
#   #     #               #           # #     #       #        E#
#################################################################
