#################################################################
#S#               #               #       #         #     #     #
# # ######### ### # ############# # # ##### ### ### ### # # #####
# #   #     #   # #     #   #   # # #         #   # #   # #     #
# ### # ####### # ##### # # ### # # ############# # # ### ##### #
# #   #   #   # #   #     #     #   #           # #   # #       #
# ### ### # # # ### ################# ######### # ##### ####### #
#   #     # #   # #     #     #   #   #   #   # #   #   #   #   #
### ####### ##### ##### # ### # # # ### ### # # ### # # # # # ###
#           #             #     #   #       #       # #   #    E#
#################################################################
