#################################################################
#S      #           #   #         #           #   #             #
####### ######### # # # # ##### # ####### ### # # ####### ##### #
# #   #         # #   #   #   # #         # #   #       #     # #
# # # ######### ####### ##### # ########### ########### ####### #
#   #         #       #       # #         #           # #     # #
# ######### ######### ####### # ##### ##### ### ####### # ### # #
# #       #     #   # #   #   #     # #     # # #   #   #   # # #
# ####### ##### # # # # # ######### # # ##### # # # # ##### # # #
#             #   #     #           #         #   #         #  E#
#################################################################
