#################################################################
#S  #   #     #     #       #   #       #         #             #
### # # # ### # # ### ### # # # # ### # ### ##### # ########### #
#   # # #   #   #       # #   # # # # #     # #   #   #       # #
# ### ##### ############# ##### # # # ####### # ##### # ##### # #
#   #     # #   #       # #     #   #   #     #   #   # #   #   #
### # # ### # # # ##### # # ####### ### ### # ### ##### ### ### #
#   # #     # # # #   #   #       #   #   # #   #   #   #     # #
# ########### # # # # ########### ####### # # ##### # ### ##### #
#             #   # #                     # #         #        E#
#################################################################
