#########################
#S#   #             #   #
# # # ### ######### ### #
# # #     #       #   # #
# # ####### ##### ### # #
# #       #   #     # # #
# ### ### ##### ### # # #
#   #   #     # #   #   #
### ######### # ####### #
# #       #   # #   #   #
# ####### # ### # # # ###
#     # #   #   # #   # #
### # # ##### # # ##### #
#   #     #   # #       #
# ######### ### ####### #
#     #       #   #   # #
# ### # ####### # # # # #
#   #   # #     #   # # #
### ##### # ####### ### #
#   #     #   #     #   #
# ##### # ### ##### # ###
# #   # # #   #   # # # #
# # # # # # ### # ### # #
#   #   # #     #      E#
#########################
