#################################################################
#S#       #     #     #               #         #               #
# ### ### # ### # ### ############### # ### ### # ##### ####### #
#     # #   # #   # # #     #   #     #   #   # #     # #   #   #
####### ##### ##### # # ### # # # ####### ### ##### ### # # # ###
#     #         # #   #   # # #   #     #   #       #   # #   # #
# # ### ### ### # # ##### # # ##### # ##### ####### # ### ##### #
# #     # #   #   # #     # #       #       #     # # # # #     #
# ####### ### ##### ### ### ################# ### ### # # ### # #
#           #           #                     #       #       #E#
#################################################################
