#########################
#S#               #     #
# ##### ### # ##### # # #
#     # #   # #     # # #
##### ### ##### ##### # #
#   #   # #   # #   # # #
# # ### # # # # # # # # #
# # #   #   #   # # # # #
# ### ### ######### # ###
#     # #         # #   #
# ##### ######### # ### #
#   #         #       # #
### # ### ##### ####### #
# # #   #       #     # #
# # ### ######### ### # #
# # #       #   #   #   #
# # ####### # # ### ### #
# # #     #   #   # # # #
# # # ### ####### # # # #
# #   # #   #     # #   #
# ##### ### # ##### # ###
#   #     # # #   # # # #
# ### # ### ### # # # # #
#     #         #   #  E#
#########################
