#################################################################
#S# #     #       #           #     # #         #             # #
# # # # # ##### # # ####### # # ### # # ### ### # ####### ### # #
# #   # # #     # # #       #   # # #   #   # # # #     #   # # #
# ##### # # ##### ### ########### # ##### ### # # # ### ### # # #
#       #   #   #   # #     #   #   #   # #   # # # #   #   # # #
############# # ### # ### # ### # ### # # # ### ### # ### ### # #
#         #   #     # #   #     # #   # # #   # #   # #   # # # #
# ####### # ######### # ######### # ### # # # # # ### # ### # # #
#       #             #             #     # #     #     #      E#
#################################################################
