#########################
#S  #       #   #       #
### # ##### # # # # ### #
# #   #     # #   # #   #
# ##### ##### ##### #####
#     # #     #   # #   #
# ##### # ##### # # # # #
#   #   # #     # #   # #
# # # ### # ##### ##### #
# #   #   # #   # # #   #
# ##### ### ### # # # ###
# #   # #     #     #   #
# # # # # ### ######### #
# # # # # #   #   #   # #
# ### # ### # # # # # # #
#   # # #   # # #   #   #
### # # # ### # ####### #
#   #     #   #   #   # #
# ####### ####### ### # #
#       # #     #   # # #
####### ### ### # # # # #
#     #     #   # # # # #
# ########### ##### # # #
#                   #  E#
#########################
