#################################################################
#S    #         #             #     #         #               # #
##### # ####### # ####### ### # ##### # ##### ### ########### # #
#   # #   #   # #   #   #   # #       # #   #   # # #       # # #
# ### ### # # # ### ### ### # # ####### ### ### # # # ##### # # #
#     #   # # #   #     #   # # # #   # #     #   # # #   # #   #
# ##### ### # ### ##### # ### # # # # # # ######### # # ### ### #
#     # # # #   #   #   # # # #   # #   #       #     #   #   # #
##### # # # ### ### ##### # # ##### ##### ##### # ####### # ### #
#       #     #           #         #         #           #    E#
#################################################################
