#################################################################
#S#     #   #     #           #     #             # #       #   #
# ### ### # # ### # ####### ### # ### # ######### # # ### # # # #
#   # #   #     # # #   #   #   # #   # #   #   #   # # # #   # #
### # # ######### # # ### ### ### # ### # # # # ### # # # ##### #
# # #       #   #   # #   #     #     #   #   #   # #   # #     #
# # # ####### # ### # # ### ############### ##### ### ### # #####
#   # #       #   #   #     #   #         #     #     #   #   # #
# ##### ######### ########### # # ####### ############# ##### # #
#       #                     #   #                     #      E#
#################################################################
