#########################
#S  #         #         #
### ### ##### ####### # #
#   #   #   #       # # #
# ### ### # ####### ### #
# #     # #   #   # #   #
# ### # ### # # # # # # #
#   # #   # # # # #   # #
### ##### # # ### ##### #
# #       # #   #   #   #
# ######### ### # ### ###
# #   #     # #   #   # #
# # # # # ### ### # ### #
#   #   #   #     # #   #
########### ##### # ### #
#           #   # #   # #
# ########### # ##### # #
#         #   #     #   #
# ####### # ####### ### #
#     # #   #     # #   #
##### # ####### ### # ###
#   #     #     #   #   #
# ####### # ### # ##### #
#           #   #      E#
#########################
