#################################################################
#S#     #     #             #     #     #     #               # #
# ### # ### # # # ######### # ### ### # # # # ####### # ##### # #
# #   #     # # #   #       # # # #   # # # #       # # #   # # #
# # ######### ##### # ####### # # # ### ### ####### ### # ### # #
# # #   #   #   #   #       # #   # #   #   #   #   #   #   # # #
# # # # # # ### # ######### # ### # ### # ### # # ### ### # # # #
#   # # # #     #     #   # #   # #   # # #   # #     #   # # # #
##### # # ########### # # # ### # ### # # # # ######### ### # # #
#     #               # #       #     #   # #             #    E#
#################################################################
