#########################
#S  #   #               #
### # ### ### ###########
# # #       #       #   #
# # # ########### # # # #
# # # #   #     # #   # #
# # # # ### ### ### ### #
#   #   #   # #   #   # #
# ##### # ### ### ##### #
# #     #   #   # #   # #
# ######### ### # # # # #
#   #     # #   # # #   #
### # ### # # # # # ### #
#   #   #   # # #   # # #
# ### # ##### ####### # #
# #   # #   #         # #
# # ### # # # ### # ### #
# # #   # # #   # # #   #
# ### ### # # ### ### ###
#   # #   # # #   #   # #
### # # ##### # ### ### #
# #   #   #   #   #     #
# ##### # # ##### ##### #
#       #       #      E#
#########################
