#########################
#S              #       #
############### ### # # #
#     #   #   #   # # # #
# # ### # # # ### ### # #
# #     # # #   # #   # #
##### ### # # # # # ### #
#   # #   # # # #   #   #
# # ### ### # ####### ###
# #   #     #   #   #   #
# ### ######### # # ### #
# # #       #   # #     #
# # ####### # ### #######
# #       # #   #   #   #
# # ####### ### ### # # #
# #             # # # # #
# ### ######### # # ### #
#   #     #   #   #   # #
# # ##### # # ####### # #
# #     # # #         # #
# ##### # # ########### #
# # #   # # #     #     #
# # # ##### ### # ##### #
#   #           #      E#
#########################
