#################################################################
#S  #     #     #           #     #           #           #     #
### ### # ### # # ######### ##### # # ####### # ##### ### # ### #
# #     #   # # # #       # #   #   #     # # # #     #   #   # #
# ######### # # # ####### # # # ### ##### # # ### ##### ##### # #
#         #   # #   #     #   #   #     # # #   #     #       # #
# ##### ####### # # # ########### ### ### # ### ### # ######### #
# #   #       # # # #   #   #     #   #   #   #   # # #   #     #
# ### ### ##### ### # # # # # ######### ### # ### ### # # # #####
#       #           # #   #             #   #         # #      E#
#################################################################
