#########################
#S# #             #     #
# # # # ######### # # ###
# # # #   #   #   # #   #
# # # ### # # # ### ### #
# #   # # # # #   # # # #
# # ### # # ##### # # # #
# #     # #       #   # #
# ##### # # ####### ### #
#   #   # # #       #   #
### ### # # ######### ###
# #   # # #         #   #
# ### # # ######### # # #
#     # # #       # # # #
# ##### # # ### ### ### #
#     # # #   #     #   #
##### # # ### ####### ###
#     # # #     #       #
# ##### # ##### ####### #
#     # #     #         #
##### ####### ######### #
#   # #       #       # #
# ### # ####### # ##### #
#       #       #      E#
#########################
