#########################
#S  #     #   #         #
### # ### # # ######### #
# # # #     #       #   #
# # # ############# # # #
#   #     #   #       # #
# ### ### # # ######### #
# # # #   # #     #     #
# # # # # # ##### # #####
# # # # # # #     # #   #
# # # # # # # ##### ### #
# #   # # # #     #     #
# # ### ### ##### ##### #
# #   #       #   #   # #
# ### ######### ### ### #
# #   #     #   #   #   #
# # ### ### # ### ### ###
# #     #   # #   #   # #
# ####### ### # ### ### #
#       # #   # #   #   #
####### ### ### # ### # #
#     #   #   # #     # #
# # ##### ### # ####### #
# #           #        E#
#########################
