#################################################################
#S    #   #         #   #     #             #       #       #   #
##### # # # # ##### # # ### # # ######### # # # ### # ### # ### #
#   #   # # #     #   #     # # #         # # # #   # #   #   # #
# ####### # ##### ########### # # ######### ### # ##### ##### # #
#       # #     #   #       # # # #       # #   #   #   #     # #
### ##### ######### # # ##### # # ##### # # # ##### # ### ##### #
#   #     #   #     # # #     # #     # # # # #   #   #   #   # #
# ### ##### # # ##### ### ########### # ### # # ####### ### # # #
#           #   #                     #       #             #  E#
#################################################################
