#################################################################
#S#     #     #                     #   #     #     #         # #
# ### # ### ### ########### ####### # ### # # ### # # ####### # #
# #   #   #   #     #     # #     # #   # # #   # #   #     #   #
# # ##### # # ##### # ### # # # ### ### # # ### # ##### # ##### #
# #     # # #       #   #   # #   #   #   #   #   #   # #       #
# ##### # ### ####### # ##### ### ### # ##### ##### # # #########
#   #   #   #   #   # #   #   #   #   # #     #     #   #     # #
### # ##### ##### # ##### # ### ### ##### ##### ########### # # #
#     #           #       #   #           #                 #  E#
#################################################################
