#########################
#S#       #     #     # #
# ### ### # ### # ### # #
#     # #   # #   # # # #
####### ##### ##### # # #
#       #       # #   # #
# # ### ### ### # # ### #
# # #   #   # #   # #   #
# # # ### ### # ### ### #
# # #   # #   # #   #   #
# # ### # # ### # ### ###
# # #   # # #   # #     #
# # # ### # # ### ##### #
# # #     #   #   #     #
### ####### ### ### ### #
#   #     #   # #   #   #
# ### ### # ### # ##### #
# #   #   # #   #     # #
# # ### # ### ##### # ###
# #   # # #   #   # #   #
# ### # ### ### # ##### #
#     #     #   # #   # #
# ########### ### # # # #
#             #     #  E#
#########################
