#########################
#S  #   #         #     #
### # ### ##### # ### # #
#   #       # # #     # #
# ######### # # ####### #
#       #   # # #       #
####### # ### # ####### #
#   #   #   # #   #   # #
# ### ##### # ### # # # #
#     #   #     #   # # #
# ##### # ##### ##### # #
#     # #   #     #   # #
##### # ### ####### ### #
#     #   #     #   #   #
# ##### # ##### # ##### #
# #     #   #   #     # #
# ### ##### # ### ### # #
#   # #   # # #     # # #
### # # ### # # ##### # #
# # #   #   # # #     # #
# # ### # ### # # ##### #
# # #   # #   # # #     #
# # ##### # ##### # #####
#         #       #    E#
#########################
