#################################################################
#S      #       #         #               #             #       #
####### ### ### ### ### # ############# # ####### ### # ####### #
#   # # #   # #   # #   #       #       #   #   # #   # #     # #
# # # # # ### ### # # ######### # ######### # # # # ### # ### # #
# #   # # #   #   # # #       # #   #     #   # # #   # # # # # #
# ##### # # # # ##### ### # ### ### # ######### ##### # # # # # #
# #     # # # #     #   # # #   #   #   #       #   # #   # # # #
# # ##### # # ##### ### # # # ### ### # # ####### # # ##### # # #
#         # #           # #       #   #           #   #        E#
#################################################################
