#########################
#S#       #         #   #
# # # ### # ####### # # #
# # # #   #     #   # # #
# # # # ### ### ##### # #
# # # #   #   #       # #
# ### ### ######### ### #
#   #   #     #   # #   #
### ### ##### # # ### # #
# #   # #   #   #   # # #
# ### # # ######### # # #
#   # # #       #   # # #
# ### # # ### ### ### # #
#   #   #   # #   #   # #
### ######### # ### ### #
#   #         #     #   #
# # # ##### ######### ###
# #   #     #       #   #
# ##### ##### # ####### #
# #         # #         #
# # ######### ###########
# #   #   #   #   #     #
# ##### # # ### # ##### #
#       #       #      E#
#########################
