#################################################################
#S  # #                   #         #           #           #   #
### # # ############### ### # ##### ####### ### ### ####### ### #
# # # # #       # #   #     #     #       # # #   # #     #   # #
# # # # ##### # # # # ##### ##### ####### # # ### # ##### ### # #
#   # #       # # # #     # #   # #   #   # #     # #       #   #
# ### ### ##### # # ##### # # # # # # # ### # ##### # ######### #
# #       #   #   #   # # # # #   # # # #   # #     # #   #   # #
# ######### # ####### # # ### ##### ### # ### # ##### # # # # # #
#           #         #       #           #     #       #   #  E#
#################################################################
