#########################
#S    #             #   #
##### ##### ####### ### #
#   #     #   #   #     #
# ####### # # # # ##### #
#       # # #   #   #   #
# ### # # # ####### # ###
#   # # # #     #   # # #
##### # # ####### ### # #
#     # #       # #     #
# ############# # #######
#             # #       #
# ##### ##### # # ##### #
# #   #     # # #   #   #
# # # ##### # # # ### # #
#   # #     # # # #   # #
##### # ##### # ### ### #
#   # # #     #     #   #
# # # # ############# ###
# #   #         #   #   #
# ########### ### # ### #
# #       # # #   #   # #
# # ##### # # # ### ### #
#   #       #     #    E#
#########################
