#########################
#S      #         #     #
####### # ##### ### ### #
#   # # #   #   #   # # #
# # # # # # ##### ### # #
# #   # # #           # #
# ##### ############### #
# #     #       #       #
# # ##### ##### # ##### #
#   #     #   # #   # # #
# ### ##### ### ### # # #
#   # #     #   #   # # #
### # ##### # ### ### # #
# # #     #       # #   #
# # # ### ######### # ###
# # # # #     #     # # #
# # # # ##### ##### # # #
#   # #     # #   # #   #
# ### ### # # # # # ### #
#   #     # #   # #     #
### ####### ##### # #####
# #   #   # #     #   # #
# ### # # ### ####### # #
#       #     #        E#
#########################
