#################################################################
#S          #           #           #       #   #   #           #
########### # ####### # # ####### ### # ### # # # # ### ####### #
#       #   # #       # #     # #     #   #   # # #   #     #   #
# ####### ### # ####### ##### # ######### ##### # ### # ### # ###
# #       #   #   #   #   #     # #   #   #   #   #   #   # # # #
# # ############# ### ### ##### # # # # ### ####### ####### # # #
# # #   #   #   #   #   # #   #   # # #   # #       #     # # # #
# # # # # # # # ### # ### # # ##### # ### # # ####### ### # # # #
#     #   #   #     #       #       #     #           #     #  E#
#################################################################
