#################################################################
#S      #       #               #       #   #       #     #   # #
####### # # ### # ############# ### ### # ### # ### # ### # # # #
#     # # #   # # #   #       #     #   #     # # # # #   # #   #
##### # ### # # # # # ### ### ####### ######### # # # # ### #####
#   # #   # # # #   #   # #     #   # #         # # # # #       #
# # # ### ### # # ##### # ####### # # # ######### # # # # ##### #
# #     #     # # #   # #   #   # #   # # #       # # # # #     #
# ############# ### # # # # # # # ##### # # ##### # # # ### ### #
#                   #   # #   #         #       #     #     #  E#
#################################################################
