#################################################################
#S#   #       #               #   #                   #       # #
# # # # ### ### ######### ### # # # # ############### # ##### # #
# # # #   #     #       # # # # # # #           #   #   #     # #
# ### # ######### ##### # # # ### # ########### # ####### ##### #
#   #   #       #     #   # #   #       #     # #       #   #   #
### ##### ##### ##### ##### ### ####### ### ### ####### ### ### #
# #       #   #     #   # #   # #   #       #   #         #     #
# ######### ####### ### # # # # # # ######### ### ############# #
#                       #   #     #           #                E#
#################################################################
