#########################
#S#       #     #       #
# ### ### # # # # ##### #
#   # # # # # # # #     #
### # # # ### # # # ### #
# # # # #   # # # #   # #
# # # # ### # ### ### # #
# #   # #   #   #   # # #
# ##### # ##### # ### # #
# #       #     # #   # #
# # ######### ### # ### #
# # #       # #   # #   #
# # # ### # # # ### # ###
# # # #   # #     # # # #
# # # # ### # ##### # # #
# # # # # # # #     # # #
# # ### # # ### ##### # #
# #     # # #   #   #   #
# ####### # # ##### ### #
#         # # #       # #
# ##### ### # # ##### # #
#     #   #   #     # # #
##### ### ##### ### ### #
#       #         #    E#
#########################
