#################################################################
#S#           #     #             # #             #       #     #
# # # ####### # ### # ##### ##### # # ####### ### ### ##### ### #
# # #   #   # #   #       # #     #   #   #   # #   #       #   #
# # ### ### # ############# # ####### # # # ### ### ######### # #
# # # # #   #           #   # #     #   # #   #   #       #   # #
# # # # # ############# # ### # # # ##### ### # # ####### # ### #
# #   # #         #   #   # # # # #   #     # # #   #   #   #   #
# ##### # # ####### # ##### # ### ### ####### # # ### # ##### ###
#       # #         #             #           # #     #        E#
#################################################################
