#################################################################
#S#             #   #               #       # #   #         #   #
# ####### ### # # # # # # ######### ##### # # # # # ##### ### # #
#       #   # #   # # # # #     #   #     # #   #       #     # #
####### ##### ####### # ### ### # ### ##### ############### ### #
#     #     #         #       # # #   #   #   #   #       # #   #
# ### ##### ################### # # ### # ### # # # ##### ### ###
#   # #   #   #       #   #   # #   #   #     # #   #   #   #   #
### # # # ### # ##### # # # # # ##### ######### ##### ##### ### #
#   #   #       #       #   #   #               #              E#
#################################################################
