#########################
#S#     #       #     # #
# ### # # ##### # # # # #
#   # # # #     # # #   #
### # # # # ####### ### #
# #   #   # #       # # #
# ######### # ### ### # #
#       #   # # # #   # #
# ### ### ### # # # ### #
# #   #   #     # #   # #
# # # # ### ##### # # # #
# # # # #     #   # #   #
### # # ##### # ### #####
#   # #     # #   #     #
# ######### ##### ##### #
#         #     # #   # #
# ####### ##### # # # # #
#   #   #     #   # #   #
### # # # # ####### #####
#   # #   # #     # #   #
# ### ####### ### # # # #
#   # #   #   # # #   # #
### # # # # ### # ##### #
#   #   #       #      E#
#########################
