#################################################################
#S#   #           #   #         #     #               #         #
# ### # ####### # # # # ##### # # ##### ########### # # ####### #
#   #   # #   # #   # #   # # # #       #         # #   # #     #
### # ### # # # ##### ### # # # # ####### ####### ##### # # #####
# # #     # #   #     #     # # #     #   # #   #     #   #     #
# # ### ### ##### ##### ##### # # ##### ### # # ##### ##### ### #
# #   # #   #   # #     #     # # #     #   # # #   #     #   # #
# ### ### ### ### ####### ##### ### ##### # # # # # ##### ##### #
#         #               #         #     #   #   #            E#
#################################################################
