#################################################################
#S    # #         #                 #           #     #   #     #
##### # # ####### # # ############# # ######### ##### # # # ### #
# #   #   #     #   #     #   #     # #       #     #   #     # #
# # ####### ### ######### ### # ##### # ########### # ####### # #
# #   #   # # # #   #   #   # # #     # #   #   #   # #     # # #
# ### # # # # # # # # # # # # # # ##### # # # # # ##### ### # # #
#   # # # # # # # # # # # # #   #   #   # #   #   #   # # # # # #
# ### # # # # # # # # # ### # ##### # # # ######### # # # # ### #
#       #   #     #   #     #       # #             #   #      E#
#################################################################
