#################################################################
#S#                 #     #   #               #   #       #   # #
# ### ############# ### # # # ##### ######### # # # ##### # # # #
# #   #   #       # #   #   #     #   # #     # #   #   #   #   #
# # ### # # ### ### # ########### # # # # ##### ##### ######### #
# # #   #   #   #   #     #     # # # # # #     # #         #   #
# # # ##### ##### ####### ### # # ### # # ### ### # ####### # ###
# # # #   # #   # #     #   # # # #   # #   #   # # #       #   #
# # # # # ### # # ### # ### # ### # ### ### ### # # # ######### #
#   #   #     #       #     #       #           #   #          E#
#################################################################
