#################################################################
#S          #           #           #           #       #       #
########### ####### ### # # ####### # ##### ### # # ### ### #####
#       #   #       # # # # #     # #   #   #   # #   #   #     #
##### # # ### ####### # ### # ### # # ### ### ####### ### ##### #
#     # # #   #       #     #   # # # #   #   #     # # # #     #
# ##### # # ####### # ########### # # # ### ##### # # # # # ### #
#     # #   #       #     #       # # # #   #     #   #   # #   #
# ### ####### ############# # ##### ### # ### ######### ### # ###
#   #                       #           #     #             #  E#
#################################################################
