#################################################################
#S#                     #     #   #                     #     # #
# ##### ########### ### # ### # # ####### ##### ####### # ### # #
#     #   #     #   #   # # #   #       # #     #     # # # #   #
##### ##### ### # ### ### # ########### # # ##### ### # # # ### #
#   # #   #   #   # # #   #           # # #     # #   #   # #   #
### # # # # # ##### # # ### ########### # ##### # ######### # ###
#   # # # # # #     #   # #     #   #   # #   # #   #         # #
# ### # # ### # ######### # ### # # # ##### # # # # # ######### #
#       #     #               #   #         #   # #            E#
#################################################################
