#################################################################
#S  #       #       #   #       #                 #     #       #
### # ##### # # ### ### # # ### ### ### ### ##### ### # # ##### #
# #   #     # #   #   # # # # #   #   #   # #   # #   #   # #   #
# ##### ##### ### ### # # # # ### ####### # # # # # ####### # ###
#     # #     #   #   # # # #   # #     # # # # # #     #   #   #
# # ### # ##### ### ### # # # # # # ### # ### # # # ### # # ### #
# # #   # #     #   #     # # #   # # # #     # # # #   # #   # #
# ### ##### ##### ######### # ##### # # ####### # ### ### ### # #
#           #               #       #           #     #     #  E#
#################################################################
