#########################
#S  #         #         #
### # ### ### # ####### #
#   # #   # # #       # #
# ##### ### # ####### # #
# #     #     #       # #
# # ##### ##### ####### #
#   # #   #     #       #
##### # ### ####### #####
#     # #   #     #     #
# # ### ### # ### ##### #
# # #   #   # # # #     #
# # # ### # # # # #######
# #   #   # # # #   #   #
# ##### ### # # ### # # #
#     # #   #     #   # #
##### # ######### ##### #
#     #           #   # #
# ######### ##### ### # #
#   #     # #   #     # #
### # ### # # # ####### #
# # #   # # # #     #   #
# # ### # ### ##### # # #
#       #     #       #E#
#########################
