#################################################################
#S#         # #         #           #         #   #           # #
# ### ##### # # ##### # # ##### ### # # ##### ### # ### ##### # #
#   # #   # #       # # #     # # # # # #   #   #     # #     # #
### # # ### ####### # # ### ### # # # # # # ### ####### # ##### #
# #   #   #   # #   # #   # #   # # # #   # # # #       #   #   #
# ####### ### # # ### ### ### ### # # ##### # # # ######### ### #
#   #     #   #   #   # #     #     # #     # # #     #   #   # #
# ### # ### ####### ### ####### ####### ##### # ##### # # ### # #
#     #             #                   #             # #      E#
#################################################################
