#########################
#S  #     #     #       #
### # ##### ### # ### # #
# # #     #   #   #   # #
# # # ### # ####### #####
#   #   #   #     #     #
# ####### ### ### # ### #
#       # #   # # # #   #
####### # # ### # # # ###
#     # # # #   # # #   #
# # # # ### ### # ### # #
# # # #     #   #   # # #
# # ######### # ### # # #
# #         # #   # # # #
# ##### ### # # ### ### #
# #   # # #   # #   #   #
# # # # # ##### # ### ###
#   # # #       # #     #
##### # # ##### # ##### #
#   # # # #   # #       #
# ### # # # # ######### #
# #   # # # # #       # #
# # ### ### # # # ##### #
#     #     #   #      E#
#########################
