#########################
#S#   #   #         #   #
# # # # # # ####### ### #
#   # # # #     # # #   #
##### # # ##### # # # # #
#   # # #     # # #   # #
# # # # ##### # # ##### #
# # # # #   # # #     # #
# # # # # # # # # ##### #
# # #   # # #   #     # #
# ######### ##### ### # #
#     #         #   # # #
# # ### # ##### ### # # #
# # #   # #     #   #   #
# # # ### ### ### #######
# #     #   # #   #     #
# ######### ### ### ### #
#     #     #   #   #   #
##### # ##### ##### # ###
# #   #     #     # #   #
# # ####### ##### ##### #
# # #   # # #   #     # #
# # # # # # # # ##### # #
#     #   #   #        E#
#########################
