#################################################################
#S#   #               #           #       #             #   #   #
# # # ############# ### ### ##### ##### # # # ######### # # ### #
#   # #     #     # #     # #   #       # # # #     #   # #     #
##### # ### # ### # # ##### # ########### ### # # ### ### #######
#   # # # #   #   #   #   # #       #     #   # # #   #         #
### # # # ##### ####### # # ##### # # ##### ### ### ####### ### #
#   # # # #     #     # # #     # # # #       # #   #     # #   #
# ### # # # ##### ### # # ##### # # # ####### # # ### ### ### # #
#       #         #     #       # #           #       #       #E#
#################################################################
