#########################
#S#   # #     #       # #
# # # # # # # ### ### # #
#   # # # # #     #   # #
##### # # # ####### ### #
#     #   # #     #     #
# ######### # ######### #
#     #     #         # #
##### # ##### ####### # #
#   #   # #       #   # #
### ##### # ####### # # #
#     #   #   #     # # #
# ##### # ### # ####### #
#       #     #       # #
# ################### # #
# #     #       #   #   #
# # ### ### ### # # #####
#   # #     # #   #     #
##### ####### ######### #
#     #     #   #     # #
# ### # # ### # # # ### #
#   # # #     #   #     #
### # # #################
#   #                  E#
#########################
