#########################
#S    #   #   #     #   #
##### # # # # # ### ### #
#   #   # # # # #   #   #
# ####### # # # # ### ###
#       # # #   #   #   #
# # ##### # ####### ### #
# # #     # #           #
### # ##### ########### #
#   #   #     #       # #
# ##### ### # # ##### # #
#     #   # # # # #   # #
##### ### # # # # # ### #
#       # # #     # # # #
# ####### # ####### # # #
#         #   #     # # #
# ########### # ##### # #
#   #   #     #     #   #
### # # ########### # ###
#   # # #     #     #   #
# ### # # ### # ####### #
#   # # # # # # #   #   #
### # # # # # # # ### ###
#     #   #     #      E#
#########################
