#################################################################
#S#           #     #             #         #   #             # #
# # # ####### ### # # ########### # ##### # # # # ##### ##### # #
# # #       #     #   #       #   # #     #   # # #     #   # # #
# ##### ### ########### ##### # ### # ######### ### ##### # # # #
#     # #   #         # # #   # #   #         #   # #   # #   # #
##### ### ### ####### # # # # # ####### ##### ### # ### # ##### #
#   #     # #   #     #   # # # #     #     #   #   #   # #     #
# ######### # # ######### # ### # ### ######### ##### ### ##### #
#             #           #       #             #              E#
#################################################################
