#################################################################
#S# #         #         #             #       #         #       #
# # # # ####### # ####### ####### # # ####### # ##### # ####### #
# #   #     #   #       # #     # # #   #     # #   # #       # #
# ######### # ######### # # ### ### ### # ##### # # # ####### # #
#         #     #     #   # #   #   #   #       # # #   #   # # #
######### ##### ### # ##### # ### ### ##### ##### # ### # # # # #
# #     #   #       # #     # #   # # #   # #   # #   # # # #   #
# # # ##### ########### ##### # ### # # # ### # # ### # # ##### #
#   #                   #       #       #     #   #     #      E#
#################################################################
