#################################################################
#S# #     #       #     #         #                 #         # #
# # # # # ### ##### ### # # ##### ### ##### ####### # ##### # # #
# #   # #   #         #   #   # #   #     # #       #     # # # #
# ### # ### ######### ####### # ### ####### # ######### ### # # #
#   # #   #   #     #     #   #   #         #   #       #   # # #
### ##### ### # ### ####### ### # ############# ######### ### # #
# # #   #   #   # #       #   # #       #     #   #       # # # #
# # # # ### ##### ####### ### # ######### # ##### # ####### # # #
#     #     #                 #           #         #          E#
#################################################################
