#########################
#S        # #           #
######### # # ######### #
#     # # #       #   # #
# ### # # # ####### # # #
#   #   # # # #   # #   #
# # ##### # # # # # ### #
# #       #   # #   # # #
# ######### ### ##### # #
# #       # #   #   #   #
# ### ### ### ### # #####
#     # #   # #   #     #
####### ### # # ####### #
#   #     # # #   #     #
### # ### # # ### # ### #
#   #   #   #   # # # # #
# ##### ####### # # # # #
# #     #     #   # #   #
# # ####### # ### # ### #
# #         #   # #   # #
# ############# ##### ###
# #     #     # #   #   #
# # ### # # ### # # ### #
#     #   #       #    E#
#########################
