#################################################################
#S#   #         #           #       #         #   #       #     #
# # # # # ##### ######### # # ##### # ##### # # # # ##### # ### #
# # # # # #               #   #     #     # #   #   #   # #   # #
# # # ### ##################### ######### # ########### # ##### #
#   #   #     #       #   #   #   # #   # #   #   #     #   #   #
####### ##### # ##### # # # # ### # # # # ### # # # ####### # # #
# #     #     # #   # # # # #   # #   #   #   # #   #     # # # #
# # ##### ##### # # ### # # ### # ######### ### ##### # ### # # #
#         #       #     #     #             #         #       #E#
#################################################################
