#########################
#S  #         #       # #
### ### # ##### # ### # #
#   #   # #     #   #   #
# ### # ### ##### # #####
#   # # #   #   # #     #
### # ### ### # ####### #
#   #   # #   #       # #
# ### # # # ######### # #
#   # #   #       # #   #
### ##### ####### # ### #
# #     # #     # # #   #
# ##### ### ### # # # ###
#     #   # #   # #     #
# # ##### # ### # #######
# #       #   # #       #
# ########### # # ##### #
# #     #     # # #   # #
# # # # # ##### ### # # #
# # # #   #   # #   # # #
# # # ##### # # # ### # #
# # # # #   #   # # #   #
# ### # # ####### # ### #
#     #           #    E#
#########################
