#################################################################
#S  # #   #         # #   #       #       #   #       #         #
### # # # # ### ### # # # # ### # ##### # # # ##### # ### ### # #
#   #   #     #   # #   #   #   #       #   #   #   #   #   # # #
# ### ####### ### # ##### ### ################# # ##### ##### # #
# #   #     # #   #     #   #   #             # #   # #       # #
# ##### ### ### ####### ####### ########### # # ### # ######### #
#   #   # # #   #     #   #   #     #       # #   # # #     #   #
### # ### # # ### ### ### # # ##### # ########### # # # # ### ###
#     #       #     #       #       #               #   #      E#
#################################################################
