#################################################################
#S      # #             #                     #     #           #
####### # # ####### ### # ################### # ### # ### ##### #
#       #       #   # # # #     #     #     #   #   # # #     # #
# ####### ####### ### # ### ### # ### # ### ##### ### # ##### ###
#   #       #     #   #   # #   # # # # # #     #       #   #   #
### # ##### # ##### ##### # # ### # # # # ##### ### ##### # # # #
# # # #   # # #     #   # # #     #   # #     #   # #   # # # # #
# # ### # ### # ### # # # # ####### ### # ### ### ### # # # ### #
#       #     #   #   #     #           #   #         #   #    E#
#################################################################
