#########################
#S# #                   #
# # # # ############### #
# #   #     #           #
# # ####### #############
# #     #   #     #     #
# # ##### ### ### # ### #
# # #     #   # #   #   #
# ### ##### ### ##### # #
#   #     # #   #     # #
### ### # # # # # # #####
# #   # #     # # # #   #
# ### ########### ### # #
#   #           #     # #
# # ########### ####### #
# # #   #     #     #   #
# ### # # # ####### # ###
#     #   #         #   #
# ##################### #
#     #     #         # #
##### ### # ##### ### # #
#   # #   # #   #   # # #
# ### # ### # # ### # # #
#       #     #     #  E#
#########################
