#########################
#S#           #     #   #
# # # ####### ### # # # #
# # #       #     #   # #
# ##### ### ########### #
#     # #   #   #       #
##### ### ### # # #######
#   #     #   #   #     #
# ######### ####### ### #
#           #   #   # # #
# ########### # # ### # #
#     #       # #   #   #
##### # ##### # # # # ###
# #   # #     # # # #   #
# # ##### ##### ### ### #
#   #   # #   #     # # #
# ### # # ### ####### # #
# #   #   #   #     #   #
# # # ##### # ##### # ###
# # #   #   #       #   #
# ### # ### ##### ##### #
#   # #   #   #   #     #
### ##### # # ##### #####
#         # #          E#
#########################
