#################################################################
#S    #             #             #       #   #               # #
##### # ##### ##### # ####### ### ### ### # # # # ########### # #
#   # #     # #   # #       # # #   # # # # #   # #   #     #   #
# # # ##### # # # # ##### ### # ### # # # ####### # # # ####### #
# #   #   # # # # #   #   #   #   #   #   #       # #   #     # #
# ##### # ### # ##### ##### ### # ##### ### ####### ##### # ### #
# #     # #   # #   #       # # #     # #   # #           #     #
# # ##### # ### # # ######### # # ##### # ### # #################
#   #       #     #             #         #                    E#
#################################################################
