#########################
#S#         #   #       #
# # ##### # # # ### ### #
# #   # # #   #     # # #
# ### # # ########### # #
#   #   #   #         # #
### ### ### ######### # #
#   #     # #         # #
# ######### # ####### # #
#       #   # #     # # #
####### # ### # ### ### #
#     # # #   # # #   # #
# # # # # # ### # ### # #
# # # #   #   #   # #   #
# # ####### # ### # #####
# # #     # #   #       #
### # ### # ### ####### #
#   #   #   # #       # #
# ##### ##### ####### # #
#     #     #   #   #   #
# ### ##### # # # # #####
# # #     #   # # # #   #
# # ##### ##### # # ### #
#       #         #    E#
#########################
