#########################
#S#     #   #           #
# # # ### # # ### #######
# # #     #     # #     #
# ### ########### # ### #
#   #   #       #   #   #
### ##### ##### ##### # #
# #       #   #     # # #
# ########### ##### # # #
# #     #     #     # # #
# # # # ### ### ##### # #
#   # #     #   #     # #
# ### # ##### ### #######
#   # # #     # #       #
##### # # ##### # ##### #
#     # # #       #     #
# # ##### ######### #####
# # #   #         #     #
# # # # ######### # ### #
# # # #     #     #   # #
# ### # ### # ##### ### #
#     # #   # #     #   #
# ##### ##### ####### # #
#     #               #E#
#########################
