#################################################################
#S#       #         #     #       #     #           #     #     #
# ##### # # ####### # # # ##### # # # # ##### ##### # ### # ### #
#       # # #   # #   # #     # #   # #     # # #   # #   #   # #
######### # # # # ##### ##### ####### ##### # # # ### ### ##### #
#   #     # # #     #   #   # #   #   #   # # # # #     #     # #
### # ##### # ####### ### # # # # # ### ### # # # # ### ##### # #
#   # #       #     # #   # # # # # # #   # # # # # #   #   # # #
# ### ######### ### # # # ### # # # # # # # # # # ### ### # # # #
#               #     # #       #   #   #     #       #   #    E#
#################################################################
