#################################################################
#S#       #     #       #     #       #       #                 #
# ### ### # # # ##### # ### # # # ##### # ### ########### ##### #
#   # # # # # # #     # #   # # #       # # #             #   # #
### # # # ### # # ##### # ### # ####### # # ############### ### #
# # # # #   # #   #   # # # # # #     # # #   #       #         #
# # # # ### # ##### # # # # # ### ### ### # # # ### ### #########
# #   # #   #   #   # #   #   #   # #   # # # # # #     #   #   #
# ##### # ##### # # ####### ### ### ### # # # # # ####### # ### #
#               # #             #         # #             #    E#
#################################################################
