#################################################################
#S      # #       #       #   #     #     #                     #
####### # # # ### # ##### # # ##### # ### # ############# ### # #
#   #   #   # # # #   # #   #     #     #       #   #   # #   # #
# ### ### ### # # # # # ######### ############### # # # ### #####
# #   #   #   # # # # #         #     #           #   #   #     #
# # ##### # ### # ### ### # ######### # ################# ### # #
#   #   # # #   #     #   # #   #     #   #     #       #   # # #
# ### # ### # ######### ##### # # ####### # ##### # ####### ### #
#     #     #                 #           #       #            E#
#################################################################
