#########################
#S  #             #     #
### # ########### # ### #
#   #   #   #   # #   # #
# ####### # # # # ### # #
# #       #   # #     # #
# # ########### ####### #
# #     #     # #       #
# ##### # ### # # ##### #
#     # #   #     #   # #
##### # ########### ### #
#   # #     #   #       #
# ### ##### # # #########
#   # #   #   #         #
# # # # # ##### ####### #
# # # # #     #   #     #
# # # # ##### ### # ### #
# # #   #   # # # # #   #
# # ##### # # # # # # ###
# #   #   #   #   # #   #
# # # # ########### ### #
# # # # #           #   #
# # ### # ########### ###
# #       #            E#
#########################
