#################################################################
#S#       #   #     # #     #           #   #           #   #   #
# ### ### # ### # # # # ### # # ####### # # # ######### # # # # #
#     #   # #   # # #     #   # #     # # #   #       #   #   # #
####### ### # ### # ########### # ##### # ##### ############### #
# #   #   #   # # # #       #   # #   # # #     #   #   #       #
# # # ### ### # # # # ##### # ### # # # # # # # # # # # # #######
# # #   #   #   # #   #   #   #   # #   # # # # # # # # # #   # #
# # ### ### ##### ##### ####### # # ##### # # ### # # # # # # # #
#     #           #             #         # #     #   #     #  E#
#################################################################
