#########################
#S    #     #           #
##### # ### # # # ##### #
#   # # # #   # # #   # #
# # # # # ##### ### # ###
# #   #       # #   #   #
# ######### ### # ##### #
# # #       #   # # #   #
# # # ####### ### # # ###
# #         #       #   #
# # ####### ######### # #
# # #   #   # #     # # #
# ### # # ### # ### ### #
#   # # #     # #       #
### # # ##### # ####### #
# # # #     # #     #   #
# # # ##### # ##### ### #
# #   # #   #     #   # #
# ##### # ####### ### # #
#     #   #     # #   # #
# ### # ##### # ### ### #
#   # # #   # #     #   #
### # # # # # ####### ###
#   #     #   #        E#
#########################
