#################################################################
#S        #           #         # #               #       #     #
######### # ######### # ####### # # ######### ##### # ### ##### #
#   #     # #     #   #       # #   #       #   #   # # #   #   #
# # # ##### # ### # ### ##### # ### # ##### ### # ### # ### # # #
# # # #   # #   # # #       # #   # # #   #   # # #   #   #   # #
# # # # # # # # ### ##### ### ### ### # # ### # # # ##### ##### #
# #   # #   # # #   #   # #   #   #   # #     #   # #         # #
# ##### ##### # # ### # ### ### ### ### ########### # ######### #
#       #     #       #     #       #               #          E#
#################################################################
