#################################################################
#S#     #   #                     # #         #             #   #
# # ### # ### ### ######### ##### # # ### ### ### ### ##### # ###
#   # # #       #         # #   # #   # #   #   #   # #   # #   #
##### # # ########### ### ### # # # ### ### ### ##### ### # ### #
#     # # #     #   #   #     # # #       # # #     #   #   #   #
# ### # # # ### # # ### ####### # ##### ### # ##### ### # ### ###
# #   # # # #   # # #     #   # #     # #   #     #     # #     #
# # ### ### # ### # ####### # # ##### ### ### # ######### ##### #
# #         #     #         #   #         #   #                E#
#################################################################
