#########################
#S#                 #   #
# ### ############# ### #
# #   #           #   # #
# # ############# ### # #
# # #       #       # # #
# # # # ### # ##### # # #
#   # #   #   #   # # # #
##### ### ### # # ### # #
#       #   # # #   #   #
########### # # ### ### #
#           # # # #   # #
# ######### ### # ### # #
#   #       #   #   #   #
# # ### ##### ### # #####
# #   #   #   # # #     #
# ### ##### ### # ### # #
#   #     #   #   #   # #
### ##### ### ##### ### #
#   #   #   # #   # # # #
# ##### ### # # # # # # #
#       # #   # #   #   #
####### # ##### ##### ###
#               #      E#
#########################
