#########################
#S      #               #
####### ############### #
#     # #     #         #
# ### # # ### # ####### #
#   # #   # #   #     # #
### # ##### ####### # # #
#   #   # #         # # #
# ### # # # ##### ### # #
# # # #   #   # #   # # #
# # # ### ### # ### ### #
# # #   # #   #   #     #
# # ### ### ##### #######
# #   # #   #   #     # #
# # # # # ### # # ### # #
# # # # # #   #   # #   #
# ### # # # # ##### ### #
# #   # # # #     #     #
# # ### # # ##### # #####
#   #   # # #     #   # #
### # ### ### ####### # #
# # #     #   #     #   #
# # ####### ### ####### #
#           #          E#
#########################
