#################################################################
#S        #   #         #       #           # #       #   #     #
######### # # # # ##### # ####### # ####### # # ### # # # ### # #
#       # # #   #   #     #     # # #     # #     # #   #     # #
# ##### # # ####### ####### ### # # # ### # ####### ########### #
#   #   # #       #           #   #   # # #   #   #     #       #
# # ##### # ##### ##### ######### ##### # ### # # # ### # #######
# #       # #   # #   # #       #       # # # # # # #   #       #
# ########### # ### # ### ##### ######### # # # # ### ######### #
#             #     #     #               #     #     #        E#
#################################################################
