#########################
#S#               #   # #
# ####### # ##### # # # #
#       # #     #   # # #
####### ##### # ##### # #
#     #     # # #   # # #
### # ##### ### # # # # #
#   #     #   # # # # # #
# ##### ##### # # ### # #
#     # #   #   #     # #
# ### ### # ##### ##### #
# #   #   #   # #     # #
### # # ### # # ##### # #
#   # # #   # # #     # #
# ### # # ### # # ##### #
# #   # # #   # # #     #
# ##### # # ### # ##### #
#   #   # #     #     # #
### # ### ##### ##### # #
#   # # # #     #     # #
# # # # # ##### # ##### #
# # # # #     # #   #   #
# ### # ##### ##### ### #
#           #          E#
#########################
