#########################
#S  #     #       #     #
### # ### ### ### # ### #
# # #   #   # #     # # #
# # ### ### # ####### # #
# #   # #     #   #     #
# ### # ####### # #######
#     #     #   #       #
# ##### ### # ######### #
# # #     # #   #   #   #
# # # ##### ### # # # # #
# #   # #   #   # # # # #
# ### # # ### ### # # # #
#   # # #       # #   # #
### # # ######### #######
# # # #     #   #       #
# # # ### ### # ##### # #
# # #     #   #     # # #
# # ####### ####### ### #
# #   #     # #   #   # #
# ### # ##### # # ### # #
#   # # #       #   #   #
# # # # # ######### ### #
# #     #         #    E#
#########################
