#################################################################
#S  #             #         # #     # #     #   #     #   #     #
### ##### ####### # ####### # # # # # # # # # # # ### # ### ### #
# #     #   #   # #   #   # #   # # #   # # # #   #   #       # #
# ##### # # # # # ### ### # # ### # ##### # # ##### ##### ##### #
# #     # # # # #   #   # # # #   # #     # #   # # #   # #   # #
# # ####### # ##### # # # # # # ### # ##### # # # # # # ### # # #
# # #     # #     # # # # # # # # #   #   # # # # # # #   # #   #
# # # ### # # ### # ### # # ### # ##### ### ### # # # ### # ### #
#     #     #   #       #       #               #     #     #  E#
#################################################################
