#################################################################
#S  #           #       #             #       #         #       #
### # ######### # ##### # ####### ##### ### ### ####### # ### ###
#   # #     #   # #   # #       #         #   #   #     #   #   #
# ### # ### # ### ### # ################# ### ### # ##### ##### #
# #   #   # # #     #   #             # # # # #   #       #   # #
# # # # # ### # ### ### # ########### # # # # # ########### # # #
# # # # # #   #   #   # #     # #   # #     #   #   #   #   #   #
# ### # # # ######### # ##### # # # # ########### # # # # ##### #
#     # #             #       #   #               #   #   #    E#
#################################################################
